{
  "0": "CAM",
  "1": "CB",
  "2": "CDM",
  "3": "CM",
  "4": "LB",
  "5": "LM",
  "6": "LW",
  "7": "RB",
  "8": "RM",
  "9": "RW",
  "10": "ST"
}